"a" = (/turf/closed/indestructible/rock,/area/space)
"u" = (/obj/structure/flora/tree/tall{icon_state = "tree_2"},/turf/open/indestructible/ground/outside/desert,/area/space)
"x" = (/turf/closed/mineral/random/low_chance,/area/space)
"H" = (/turf/open/floor/f13{icon_state = "purplefull"},/area/space)
"J" = (/turf/closed/wall/r_wall/rust,/area/space)
"W" = (/turf/open/indestructible/ground/outside/desert,/area/space)

(1,1,1) = {"
aaaaaaaaaaaaaaaaaaaaaaaaaaaaaaaaaaaaaaaaaaaaaaaaaaaaaaaaaaaaaaaaaaaaaaaaaaa
axxxxxxxxxxxxxxxxxxxxxxxxxxxxxxxxxxxxxxxxxxxxxxxxxxxxxxxxxxxxxxxxxxxxxxxxxa
axxxxxxxxxxxxxxxxxxxxxxxxxxxxxxxxxxxxxxxxxxxxxxxxxxxxxxxxxxxxxxxxxxxxxxxxxa
axxxxxxxxxxxxxxxxxxxxxxxxxxxxxxxxxxxxxxxxxxxxxxxxxxxxxxxxxxxxxxxxxxxxxxxxxa
axxxxxxxxxxxxxxxxxxxxxxxxxxxxxxxxxxxxxxxxxxxxxxxxxxxxxxxxxxxxxxxxxxxxxxxxxa
axxxxxxxxxxxxxxxxxxxxxxxxxxxxxxxxxxxxxxxxxxxxxxxxxxxxxxxxxxxxxxxxxxxxxxxxxa
axxxxxxxxxxxxxxxxxxxxxxxxxxxxxxxxxxxxxxxxxxxxxxxxxxxxxxxxxxxxxxxxxxxxxxxxxa
axxxxxxxxxxxxxxxxxxxxxxxxxxxxxxxxxxxxxxxxxxxxxxxxxxxxxxxxxxxxxxxxxxxxxxxxxa
axxxxxxxxxxxxxxxxxxxxxxxxxxxxxxxxxxxxxxxxxWWWWWWxxxxxxxxxxxxxxxxxxxxxxxxxxa
axxxxxxxxxxxxxxxxxxxxxxxxxxxxxxxxxxxxxxxxWWWWWWWWWWxxxxxxxxxxxxxxxxxxxxxxxa
axxxxxxxxxxxxxxxxxxxxxxxxxxxxxxxxxxxxxxxWWWWWWWWWWWWWxxxxxxxxxxxxxxxxxxxxxa
axxxxxxxxxxxxxxxxxxxxxxxxxxxxxxxxxxxxxxxWWWWWWWWWWWWWWWxxxxxxxxxxxxxxxxxxxa
axxxxxxxxxxxxxxxxxxxxxxxxxxxxxxxxxxxxxxWWWWWWWWWWWWWWWWWxxxxxxxxxxxxxxxxxxa
axxxxxxxxxxxxxxxxxxxxxxxxxxxxxxxxxxxxxxWWWWWWWWWWWWWWWWWWxxxxxxxxxxxxxxxxxa
axxxxxxxxxxxxxxxxxxxxxxxxxxxxxxxxxxxxxxxWWWWWWWWWWWWWWWWxxxxxxxxxxxxxxxxxxa
axxxxxxxxxxxxxxxxxxxxxxxxxxxxxxxxxxxJJJJJJJJJJJJJJJJJJJJJxxxxxxxxxxxxxxxxxa
axxxxxxxxxxxxxxxxxxxxxxxxxxxxxxxxxxxJHHHHHHHHHHHHHHHHHHHJxxxxxxxxxxxxxxxxxa
axxxxxxxxxxxxxxxxxxxxxxxxxxxxxxxxxxxJHHHHHHHHHHHHHHHHHHHJxxxxxxxxxxxxxxxxxa
axxxxxxxxxxxxxxxxxxxxxxxxxxxxxxxxxxxJHHHHHHHHHHHHHHHHHHHJxxxxxxxxxxxxxxxxxa
axxxxxxxxxxxxxxxxxxxxxxxxxxxxxxxxxxxJHHHHHHHHHHHHHHHHHHHJxxxxxxxxxxxxxxxxxa
axxxxxxxxxxxxxxxxxxxxxxxxxxxxxxxxxxxJHHHHHHHHHHHHHHHHHHHJxxxxxxxxxxxxxxxxxa
axxxxxxxxxxxxxxxxxxxxxxxxxxxxxxxxxxxJHHHHHHHHHHHHHHHHHHHJxxxxxxxxxxxxxxxxxa
axxxxxxxxxxxxxxxxxxxxxxxxxxxxxxxxxxxJHHHHHHHHHHHHHHHHHHHJxxxxxxxxxxxxxxxxxa
axxxxxxxxxxxxxxxxxxxxxxxxxxxxxxxxxxxJHHHJJJJJJJJJJJJJJJJJxxxxxxxxxxxxxxxxxa
axxxxxxxxxxxxxxxxxxxxWWWxxxxxxxxxxxxJHHHJxxxxxxxxxxxxxxxxxxxxxxxxxxxxxxxxxa
axxxxxxxxxxxxxxxWWWWWWWWxxxxxxxxxxxxJHHHJxxxxxxxxxxxxxxxxxxxxxxxxxxxxxxxxxa
axxxxxxxxxxxxxxWWWWWWWWWxxxxxxxxxxxxJHHHJxxxxxxxxxxxxxxxxxxxxxxxxxxxxxxxxxa
axxxxxxxxxxxxxWWWWWWWWWWxxxJJJJJJJJJJHHHJJJJJJJJJJJJJJJJJxxxxxxxxxxxxxxxxxa
axxxxxxxxxxWWWWWWuWWWWWWxxxJHHHHHHHHHHHHHHHHHHHHHHHHHHHHJxxxxxxxxxxxxxxxxxa
axxxxxxxWWWWWWWWWWWWWWWWxxxJHHHHHHHHHHHHHHHHHHHHHHHHHHHHJxxxxxxxxxxxxxxxxxa
axxxxxWWWWWWWWWWWWWWWWWWWxxJJJJHHJJJJJJJJJJHHHJJJHHHHHHHJxxxxxxxxxxxxxxxxxa
axxxxxWWWWWWWWWWWWWWWWWWWxxJHHHHHJxxxxxxxxJHHHJxJHHHHHHHJxxxxxxxxxxxxxxxxxa
axxxxxWWWWWWWWWWWWWWWWWWWWxJHHHHHJxJJJJJJJJHHHJxJHHHHHHHJxxxxxxxxxxxxxxxxxa
axxxxxWWWWWWWWWuWWWWWWWWWWxJJJJHHJxJHHHHHHHHHHJxJHHHHHHHJxxxxxxxxxxxxxxxxxa
axxxxxWWWWWWWWWWWWWWWWWWWWxJHHHHHJxJHHHHHHHHHHJxJHHHHHHHJxxxxxxxxxxxxxxxxxa
axxxxxWWWWWWWWWWWWWWWWWWWWxJHHHHHJxJHHHHHHJHHHJxJHHHHHHHJxxxxxxxxxxxxxxxxxa
axxxxxWWWWWWWWWWWWWWWWWWWWWJJJJJJJxJHHHHHHHHHHJxJHHHHHHHJxxxxxxxxxxxxxxxxxa
axxxxxWWWWWWWWWWWWWWWWWWWWWWxxxxxxxJHHHHHHHHHHJxJHHHHHHHJxxxxxxxxxxxxxxxxxa
axxxxxWWWWWWWWWWWWWWWWWWWWWWxxxxxxxJHHHHHHHHHHJxJJJJJJJJJxxxxxxxxxxxxxxxxxa
axxxxxWWWWWWWWWWWWWWWWWWWWWWWxxxxxxJHHHHHHHHHHJxxxxxxxxxxxxxxxxxxxxxxxxxxxa
axxxxxWWWWWWWWWWWWWWWWWWWWWWWWxxxxxJJJJJHHJJJJJxxxxxxxxxxxxxxxxxxxxxxxxxxxa
axxxxxWWWWWWWWWWWWWWWWWWWWWWWWWxxxxxxxxJHHJxxxxxxxxxxxxxxxxxxxxxxxxxxxxxxxa
axxxxxWWWWWWWWWWWWWWWWWWWWWWWWWWWWxxxxxJHHJxxxxxxxxxxxxxxxxxxxxxxxxxxxxxxxa
axxxxxWWWuWWWWWWWWWuWWWWWWWWWWWWWWWWWWxJHHJxxxxxxxxxxxxxxxxxxxxxxxxxxxxxxxa
axxxxxWWWWWWWWWWWWWWWWWWWWWWWWWWWWWWWWWWWWWWxxxxxxxxxxxxxxxxxxxxxxxxxxxxxxa
axxxxxWWWWWWWWWWWWWWWWWWWWWWWWWWWWWWWWWWWWWWWxxxxxxxxxxxxxxxxxxxxxxxxxxxxxa
axxxxxWWWWWWWWWWWWWWWWWWWWWWWWWWWWWWWWWWWWWWWWWWxxxxxxxxxxxxxxxxxxxxxxxxxxa
axxxxxWWWWWWWWWWWWWWWWWWWWWWWWWWWWWWWWWWWWWWWWWWxxxxxxxxxxxxxxxxxxxxxxxxxxa
axxxxxWWWWWWWWWWWWWWWWWWWWWWWWWWWWWWWWWuWWWWWWWWWWxxxxxxxxxxxxxxxxxxxxxxxxa
axxxxxWWWWWWWWWWWWWWWWWWWWWWWWWWWWWWWWWWWWWWWWWWWWWxxxxxxxxxxxxxxxxxxxxxxxa
axxxxxWWWWWWWWWWWWWWWWWWWWWWWWWWWWWWWWWWWWWWWWWWWWWWxxxxxxxxxxxxxxxxxxxxxxa
axxxxxWWWWWWWWWWWWWWWWWWWWuWWWWWWWWWWWWWWWWWWWWWWWWWxxxxxxxxxxxxxxxxxxxxxxa
axxxxxWWWWWWWWWWWWWWWWWWWWWWWWWWWWWWWWWWWWWWWWWWWWWWWxxxxxxxxxxxxxxxxxxxxxa
axxxxxWWWWuWWWWWWWWWWWWWWWWWWWWWWWWWWWWWWWWWWWWWWWWWWxxxxxxxxxxxxxxxxxxxxxa
axxxxxWWWWWWWWWWWWWWWWWWWWWWWWWWWWWWWWWWWWWWWWWWWWWWWxxxxxxxxxxxxxxxxxxxxxa
axxxxxWWWWWWWWWWWWWWWWWWWWWWWWWWWWWWWWWWWWWWWWWWWWWWWWxxxxxxxxxxxxxxxxxxxxa
axxxxxxWWWWWWWWWWWWWWWWWWWWWWWWWWWWWWWWWWWWWWWWWWWWWWWxxxxxxxxxxxxxxxxxxxxa
axxxxxxWWWWWWWWWWWWWWWWWWWWWWWWWWWWWWWWWWWWWWWWWWWWWWxxxxxxxxxxxxxxxxxxxxxa
axxxxxxxWWWWWWWWWuWWWWWWWWWWWWWWWWWWWuWWWWWWWWWWWWWxxxxxxxxxxxxxxxxxxxxxxxa
axxxxxxxWWWWWWWWWWWWWWWWWWWWWWWWWWWWWWWWWWWWWWWWWWWxxxxxxxxxxxxxxxxxxxxxxxa
axxxxxxxWWWWWWWWWWWWWWWWWWWWWuWWWWWWWWWWWWWWWWWxxxxxxxxxxxxxxxxxxxxxxxxxxxa
axxxxxxxWWWWWWWWWWWWWWWWWWWWWWWWWWWWWWWWWWWWWWWxxxxxxxxxxxxxxxxxxxxxxxxxxxa
axxxxxxxxWWWWWWWWWWWWWWWWWWWWWWWWWWxxxxxxxxxxxxxxxxxxxxxxxxxxxxxxxxxxxxxxxa
axxxxxxxxWWWWWWWWWWWWWWWWWWWWWWWWWxxxxxxxxxxxxxxxxxxxxxxxxxxxxxxxxxxxxxxxxa
axxxxxxxxxxxxxWWWWWWWWWWWWWWWWWWWWxxxxxxxxxxxxxxxxxxxxxxxxxxxxxxxxxxxxxxxxa
axxxxxxxxxxxxxxxxxWWWWWWWWWWWWWWxxxxxxxxxxxxxxxxxxxxxxxxxxxxxxxxxxxxxxxxxxa
axxxxxxxxxxxxxxxxxxxxxxWWWWWWxxxxxxxxxxxxxxxxxxxxxxxxxxxxxxxxxxxxxxxxxxxxxa
axxxxxxxxxxxxxxxxxxxxxxxxxxxxxxxxxxxxxxxxxxxxxxxxxxxxxxxxxxxxxxxxxxxxxxxxxa
axxxxxxxxxxxxxxxxxxxxxxxxxxxxxxxxxxxxxxxxxxxxxxxxxxxxxxxxxxxxxxxxxxxxxxxxxa
axxxxxxxxxxxxxxxxxxxxxxxxxxxxxxxxxxxxxxxxxxxxxxxxxxxxxxxxxxxxxxxxxxxxxxxxxa
axxxxxxxxxxxxxxxxxxxxxxxxxxxxxxxxxxxxxxxxxxxxxxxxxxxxxxxxxxxxxxxxxxxxxxxxxa
axxxxxxxxxxxxxxxxxxxxxxxxxxxxxxxxxxxxxxxxxxxxxxxxxxxxxxxxxxxxxxxxxxxxxxxxxa
axxxxxxxxxxxxxxxxxxxxxxxxxxxxxxxxxxxxxxxxxxxxxxxxxxxxxxxxxxxxxxxxxxxxxxxxxa
axxxxxxxxxxxxxxxxxxxxxxxxxxxxxxxxxxxxxxxxxxxxxxxxxxxxxxxxxxxxxxxxxxxxxxxxxa
aaaaaaaaaaaaaaaaaaaaaaaaaaaaaaaaaaaaaaaaaaaaaaaaaaaaaaaaaaaaaaaaaaaaaaaaaaa
"}
