"a" = (/turf/open/floor/wood/f13/stage_bl/outdoors,/area/shuttle/riverbarge)
"g" = (/turf/open/floor/wood/f13/stage_r/outdoors,/area/shuttle/riverbarge)
"m" = (/turf/open/floor/wood/f13/stage_b/outdoors,/area/shuttle/riverbarge)
"p" = (/turf/open/floor/wood/f13/stage_br/outdoors,/area/shuttle/riverbarge)
"q" = (/turf/open/floor/wood/f13/stage_tr/outdoors,/area/shuttle/riverbarge)
"r" = (/turf/open/floor/wood/f13/stage_l/outdoors,/area/shuttle/riverbarge)
"s" = (/obj/docking_port/mobile/supply{dir = 4; id = "riverbarge"; width = 11},/turf/open/floor/wood/f13/stage_l/outdoors,/area/shuttle/riverbarge)
"C" = (/turf/open/floor/wood/f13/stage_t/outdoors,/area/shuttle/riverbarge)
"E" = (/turf/open/floor/wood/f13/oak/outdoors,/area/shuttle/riverbarge)
"J" = (/turf/open/floor/wood/f13/stage_tl/outdoors,/area/shuttle/riverbarge)
"W" = (/turf/template_noop,/area/template_noop)

(1,1,1) = {"
JCCCCCCCCqW
rEEEEEEEEgW
rEEEEEEEEgW
sEEEEEEEEgW
rEEEEEEEEgW
rEEEEEEEEgW
ammmmmmmmpW
"}
