//MAP CONVERTED BY dmm2tgm.py THIS HEADER COMMENT PREVENTS RECONVERSION, DO NOT REMOVE
"a" = (
/turf/open/floor/wood/f13/stage_bl/outdoors,
/area/shuttle/riverbarge)
"g" = (
/turf/open/floor/wood/f13/stage_r/outdoors,
/area/shuttle/riverbarge)
"m" = (
/turf/open/floor/wood/f13/stage_b/outdoors,
/area/shuttle/riverbarge)
"p" = (
/turf/open/floor/wood/f13/stage_br/outdoors,
/area/shuttle/riverbarge)
"q" = (
/turf/open/floor/wood/f13/stage_tr/outdoors,
/area/shuttle/riverbarge)
"r" = (
/turf/open/floor/wood/f13/stage_l/outdoors,
/area/shuttle/riverbarge)
"s" = (
/obj/docking_port/mobile/supply{
	dir = 4;
	id = "riverbarge";
	width = 11
	},
/turf/open/floor/wood/f13/stage_l/outdoors,
/area/shuttle/riverbarge)
"C" = (
/turf/open/floor/wood/f13/stage_t/outdoors,
/area/shuttle/riverbarge)
"E" = (
/turf/open/floor/wood/f13/oak/outdoors,
/area/shuttle/riverbarge)
"J" = (
/turf/open/floor/wood/f13/stage_tl/outdoors,
/area/shuttle/riverbarge)
"W" = (
/turf/template_noop,
/area/template_noop)

(1,1,1) = {"
J
r
r
s
r
r
a
"}
(2,1,1) = {"
C
E
E
E
E
E
m
"}
(3,1,1) = {"
C
E
E
E
E
E
m
"}
(4,1,1) = {"
C
E
E
E
E
E
m
"}
(5,1,1) = {"
C
E
E
E
E
E
m
"}
(6,1,1) = {"
C
E
E
E
E
E
m
"}
(7,1,1) = {"
C
E
E
E
E
E
m
"}
(8,1,1) = {"
C
E
E
E
E
E
m
"}
(9,1,1) = {"
C
E
E
E
E
E
m
"}
(10,1,1) = {"
q
g
g
g
g
g
p
"}
(11,1,1) = {"
W
W
W
W
W
W
W
"}
